11111111111111111111111111111111111111111111111111
1000C000000000000000000000000000000000000000000001
1000000000000000C000000000000000000000000000000001
1000000000000000000000000000000000000000000000C001
1000000000000000000000000000000000000000000000000001
1000000000000000000000000000000000000000000000000001
1000000000000000000000000000000000000000000000000001
1000000000000000000000000000000000000000000000000001
1000000000000000000000000000000000000000000000000001
1000000000000000000000000000000000000000000000000001
1000000000000000000000000000000000000000000000000001
1000000000000000000000000000000000000000000000000001
1000000000000000000000000000000000000000000000000001
1000000000000000000000000000000000000000000000000001
1000000000000000000000000000000000000000000000000001
1000000000000000000000000000000000000000000000000001
1000000000000000000000000000000000000000000000000001
1P00000000000000000000000000000000000000000000000E01
11111111111111111111111111111111111111111111111111
