111111111111111
1P0000000000001
1000000000000C1
101111011110001
101000000010001
101011111010001
101000000010001
111111011110001
1000000000100C1
111110111111111
100010000010001
100010111010001
100000000010001
1C00000000000E1
111111111111111
