1111111111111111111111
1000000000000000000001
1000000000000000000001
1000111110000000000001
1000100010000000000001
1P00100010000000000001
1000100010000000000001
1000111110000000000001
1000000000000000000001
1000000000000000000001
100000000000C0000E0001
1000000000000000000001
1000000000X00000000001
1111111111111111111111
