11111111111111111111111111
1P00000C000100001000C00001
10000000000000000000000001
100000X00000000C0000000001
11111111111111111111111111
